NO ./textures/Bark.png
SO ./textures/bookshelf.png
WE ./textures/BrickOv.png
EA ./textures/Bricks.png

F 225,0,0
C 225,30,0

 11111111 11
1000000001001
1000N00000001
1000000001001
 11111111111