NO ./textures/Bark.png
SO ./textures/bookshelf.png
WE ./textures/BrickOv.png
EA ./textures/Bricks.png

F 225,0,0
C 225,30,0

111111111111111111111111111111111
100000000000000000000000000000001
100000000000000000000000000000001
100011111111111111111111111100001
10001                      100001
10001                      100001
10001                      100001
100011111111111111111111111100001
100000000000000000000000000000001
10000000000000000000000E000000001
111111111111111111111111111111111