


NO ./textures/Bark.png
EA ./textures/Bricks.png
SO ./textures/bookshelf.png
WE ./textures/BrickOv.png

C    1,30,0
F 225,0,               0

        111111111111111111111111111111
        100000000011000000000000000001
        101100000111000000000000000011
        10010000000000000000000011111



        1111111111111111111111111
111111111011000001110000000000001
1111101011000001110111101111111
1111111111111110111000000100000001
111


111101111111110111010100100000001
110000001101010111000000100000001
100000000000000011000000111111111
100000000000000011010100100000001
110000011101010111110111100000001   111111111111111111111111111
11110111 1110101 1011110100000001   100000000000000000000000001
11111111 1111111 1111111111111111   1000000000000000011111111
                                    11111111111111111111
111111111111111111111111111111
111111111111111111111111111111
111111111111111111111111111111